

#########
E     # #
### # # #
#   #   #
# ##### #
#     #S#
#########