


##############
#E  #        #
## ### ##### #
#    #     # #
#### # ### # #
#    # #   # #
# #### # ### #
#      #   #S#
##############