


#############################
#E        #     #         # #
######### # ### # ####### # #
#       # #   # # #     # # #
# ##### # ### # # # ### # # #
# #   # #   # # # # #   #   #
# # # # ### # # # # # #######
#   # #   # #   #   #       #
##### ### # ########### ### #
#       # #           # #   #
# ##### # ########### # # ###
# #   # #     #       # #   #
# # # # ##### # ####### ### #
#   #       #           #  S#
#############################