


###############################
#E      #       #         #   #
##### # ##### # # ##### ### # #
#     #     # # #     #     # #
# ######### # # ##### ####### #
#         # # #     #       # #
######### # # ##### ####### # #
#       # # #     #       #   #
# ##### # # ##### ####### #####
#     #   #     #         #  S#
###############################