


##############
E   #        #
## ### ##### #
#    #     # #
#### # ### # #
#    # #   # #
# #### # ### #
#      #   # S
##############