15
21
#####################
E                  ##
##### #### # # ### ##
##                 ##
## ##  # # # # ######
##               ####
###### ### ##### ####
##               ####
## ##################
##                 ##
###### ##### ##### ##
##                 ##
## ##### ##### ######
##                  S
#####################