7
9
#########
E     # #
### # # #
#   #   #
# ##### #
#       S
#########