15
29
#############################
E         #     #          ##
######### # ### # ####### # #
#       # #   # # #     # # #
# ##### # ### # # # ### # # #
# #   # #   # # # # #   #   #
# # # # ### # # # # # #######
#   # #   # #   #   #       #
##### ### # ########### ### #
#       # #           # #   #
# ##### # ########### # # ###
# #   # #     #       # #   #
# # # # ##### # ####### ### #
#   #       #           #   S
#############################