


#################################
E         #     #     #         #
######### # ### # ### # ####### #
#       # #   # #   # #       # #
# ##### # ### # ### # ####### # #
# #   # #   # #   # # #     # # #
# # # # ### # ### # # # ### # # #
#   # #     #     #   # #   #   #
##### ################# # #######
#     #       #       # #       #
# ### # ##### # ##### # ####### #
# #   #     # #     # #       # #
# # ####### # ##### # ####### # #
# #       #       #         #   S
#################################