

###############################
E       #       #         #   #
##### # ##### # # ##### ### # #
#     #     # # #     #     # #
# ######### # # ##### ####### #
#         # # #     #       # #
######### # # ##### ####### # #
#       # # #     #       #   #
# ##### # # ##### ####### #####
#     #   #     #         #   S
###############################